ἄλλος	case	OTHER
ἱκανός	null	ADJR
πᾶς	case	Q
ἅπας	case	Q
σύμπας	case	Q
ἀμφότερος	case	Q
ὀλίγος	case	Q
πολύς	case	Q
ἕκαστος	case	Q
ἑκάτερος	case	Q
οὐδείς	case	NEG+Q
μηδείς	case	NEG+Q
οὐδέτερος	case	NEG+Q
μηδέτερος	case	NEG+Q
οὐδαμός	case	NEG+ADJ
μηδαμός	case	NEG+ADJ
οὐδαμά	case	NEG+ADJ
οὐκέτι	null	NEG+ADV
μηκέτι	null	NEG+ADV
οὐδέπω	null	NEG-CONJ-CLPRT
μηδέπω	null	NEG-CONJ-CLPRT
οὐδαμῶς	null	NEG+ADV
μηδαμῶς	null	NEG+ADV
οὔποτε	null	NEG-CLPRT
οὐδέποτε	null	NEG-CONJ-CLPRT
μηδέποτε	null	NEG-CONJ-CLPRT
μήποτε	null	NEG-CLPRT
οὐδαμόθι	null	NEG+ADV
μηδαμόθι	null	NEG+ADV
δίς	null	NUM
πάντοθεν	null	ADVQ
νή	null	P
οὐ	null	NEG
οὐδέ	null	NEG-CONJ
μή	null	NEG
Περίανδρος	case,number	NPR
Κύψελος		case,number	NPR
Θρασυβούλος	case,number	NPR
Μίλητος		case,number	NPR
Ἀλυάττης	case,number	NPR
ἄν	null	AN
οὐδαμῇ	null	NEG+ADV
ὥσπερ	null	WADV-CLPRT
